ones	NNS	one
cop	NN	cop
creates	VBZ	create
thus	RB	thus
costner	NP	Costner
phil	NN	<unknown>
buddy	NN	buddy
doubt	NN	doubt
war	NN	war
sounds	VBZ	sound
henstridge	NN	<unknown>
barely	RB	barely
morgan	NN	<unknown>
prime	JJ	prime
driving	VBG	drive
seen	VBN	see
fight	NN	fight
alive	JJ	alive
apt	JJ	apt
son	NN	son
myself	PP	myself
about	IN	about
double	JJ	double
stay	VB	stay
cindy	NN	<unknown>
anastasia	NN	<unknown>
fit	VB	fit
captures	VBZ	capture
soon	RB	soon
payback	NNS	payback
willis	NNS	<unknown>
captain	NN	captain
next	JJ	next
setting	NN	setting
grinch	NP	grinch
wonder	VB	wonder
behind	IN	behind
said	VBN	say
city	NN	city
sand	NN	sand
finest	JJS	fine
dead	JJ	dead
falls	VBZ	fall
debut	NN	debut
august	JJ	august
fault	NN	fault
mix	NN	mix
very	RB	very
stereotypical	JJ	stereotypical
in	IN	in
memory	NN	memory
hope	VBP	hope
basically	RB	basically
idea	NN	idea
most	RBS	most
start	VB	start
mitchell	NP	Mitchell
pain	NN	pain
sort	NN	sort
era	NN	era
mature	JJ	mature
girlfriend	NN	girlfriend
whole	JJ	whole
depth	NN	depth
jar	NN	jar
quality	NN	quality
bother	VB	bother
tired	JJ	tired
choose	VB	choose
soul	NN	soul
%	NN	%
regular	JJ	regular
wild	JJ	wild
hospital	NN	hospital
waiting	VBG	wait
very	JJ	very
manner	NN	manner
add	VB	add
remember	VB	remember
lucas	NP	Lucas
among	IN	among
gotten	VBN	get
liked	VBD	like
cover	VB	cover
brooks	VBZ	brook
d	NN	d
whom	WP	whom
sets	NNS	set
president	NN	president
meaning	NN	meaning
claims	VBZ	claim
hours	NNS	hour
accents	NNS	accent
divided	VBN	divide
silly	JJ	silly
west	NN	west
citizen	NN	citizen
unless	IN	unless
mad	JJ	mad
bottle	NN	bottle
brown	NN	brown
requires	VBZ	require
marie	NN	<unknown>
general	JJ	general
detail	NN	detail
wish	VBP	wish
huge	JJ	huge
conspiracy	NN	conspiracy
cares	VBZ	care
played	VBN	play
least	JJS	least
little	JJ	little
s	NNS	<unknown>
size	NN	size
matter	VB	matter
middle	NN	middle
order	NN	order
lloyd	NN	Lloyd
need	NN	need
andreas	NNS	<unknown>
credit	NN	credit
naked	JJ	naked
molly	NN	molly
sadly	RB	sadly
seagal	NN	<unknown>
personality	NN	personality
reality	NN	reality
just	RB	just
die	VB	die
like	VBP	like
band	NN	band
saw	VBD	see
list	NN	list
beast	NN	beast
all	PDT	all
supposed	VBN	suppose
having	VBG	have
julie	NN	<unknown>
lucky	JJ	lucky
road	NN	road
funniest	JJS	funny
more	RBR	more
valjean	NP	<unknown>
billy	NN	billy
animation	NN	animation
scenery	NN	scenery
first	RB	first
research	NN	research
is	VBZ	be
catholic	JJ	catholic
breaks	VBZ	break
unnecessary	JJ	unnecessary
fame	NN	fame
excitement	NN	excitement
when	WRB	when
urban	JJ	urban
direction	NN	direction
heckerling	NN	<unknown>
will	NN	will
obi-wan	NN	<unknown>
'the	JJ	<unknown>
emotions	NNS	emotion
stories	NNS	storey
thanks	NNS	thank
lost	VBN	lose
000	CD	@card@
tommy	NN	tommy
along	RP	along
hired	VBN	hire
jim	NN	<unknown>
directing	NN	directing
were	VBD	be
brutal	JJ	brutal
pictures	NNS	picture
grant	NN	grant
spoilers	NNS	spoiler
exact	JJ	exact
like	IN	like
surprisingly	RB	surprisingly
century	NN	century
comic	JJ	comic
subplot	NN	subplot
trailers	NNS	trailer
find	VB	find
best	JJS	good
casablanca	NN	<unknown>
mood	NN	mood
tarantino	NN	<unknown>
choice	NN	choice
central	JJ	central
real	JJ	real
begins	VBZ	begin
musical	JJ	musical
pleasure	NN	pleasure
created	VBD	create
extra	JJ	extra
year	NN	year
cooper	NN	cooper
hall	NN	hall
believable	JJ	believable
box	NN	box
slowly	RB	slowly
8/	CD	@card@
letter	NN	letter
out	RB	out
so	IN	so
spirit	NN	spirit
bowfinger	NN	<unknown>
won	VBD	win
brad	NN	brad
help	VB	help
jokes	NNS	joke
ivy	NN	ivy
actual	JJ	actual
melodrama	NN	melodrama
weight	NN	weight
costume	JJ	costume
help	NN	help
tonya	NN	<unknown>
universal	JJ	universal
shaft	NN	shaft
produced	VBN	produce
around	RB	around
lose	VB	lose
releases	NNS	release
true	JJ	true
complex	JJ	complex
dating	VBG	date
sequel	NN	sequel
roth	NP	Roth
milton	NN	<unknown>
extremely	RB	extremely
develops	VBZ	develop
police	NN	police
again	RB	again
get	VB	get
has	VBZ	have
need	VBP	need
number	NN	number
device	NN	device
chewing	VBG	chew
naboo	NN	<unknown>
genius	NN	genius
determined	VBN	determine
jail	NN	jail
boorman	NN	<unknown>
advocate	NN	advocate
fairly	RB	fairly
monster	NN	monster
page	NN	page
cliched	JJ	cliched
biggest	JJS	big
learned	VBD	learn
josh	NN	josh
excellent	JJ	excellent
greatest	JJS	great
flying	VBG	fly
ever	RB	ever
clueless	JJ	clueless
leader	NN	leader
somehow	RB	somehow
six	CD	six
crisis	NN	crisis
emotion	NN	emotion
guess	VBP	guess
luke	NN	<unknown>
confused	VBN	confuse
sees	VBZ	see
expected	VBN	expect
jan	NP	Jan
cross	NN	cross
priest	NN	priest
straight	RB	straight
potential	JJ	potential
type	NN	type
appear	VBP	appear
allows	VBZ	allow
either	CC	either
hype	NN	hype
hackman	NN	<unknown>
suspense	NN	suspense
black	JJ	black
mst3k	NN	<unknown>
location	NN	location
mention	VB	mention
white	JJ	white
boring	JJ	boring
humorous	JJ	humorous
better	RBR	well
jurassic	JJ	Jurassic
laura	NN	<unknown>
title	NN	title
josie	NN	<unknown>
sure	RB	sure
secret	JJ	secret
missing	VBG	miss
chicago	NN	<unknown>
much	RB	much
spielberg	NP	Spielberg
intense	JJ	intense
mean	VB	mean
believes	VBZ	believe
island	NN	island
living	VBG	live
portrait	NN	portrait
except	IN	except
table	NN	table
heroine	NN	heroine
especially	RB	especially
relationship	NN	relationship
cage	NN	cage
hollywood	NN	<unknown>
gave	VBD	give
chinese	JJ	Chinese
beach	NN	beach
legends	NNS	legend
zoolander	NN	<unknown>
reese	JJ	<unknown>
tricks	NNS	trick
bess	NN	<unknown>
drugs	NNS	drug
call	VB	call
albert	NN	albert
tell	VB	tell
particularly	RB	particularly
malkovich	NP	Malkovich
prepared	VBN	prepare
darkness	NN	darkness
meet	VB	meet
firm	NN	firm
code	NN	code
bits	NNS	bit
've	VBP	have
casino	NN	casino
production	NN	production
lines	NNS	line
successful	JJ	successful
hear	VB	hear
left	VBD	leave
security	NN	security
7/	CD	@card@
somewhat	RB	somewhat
10	CD	@card@
simple	JJ	simple
postman	NN	postman
makeup	NN	makeup
niagara	NN	<unknown>
walter	NN	<unknown>
words	NNS	word
maybe	RB	maybe
simply	RB	simply
decent	JJ	decent
king	NN	king
kline	NN	<unknown>
an	DT	an
sonny	NN	sonny
t	NN	t
tim	NP	Tim
cast	VBN	cast
items	NNS	item
pace	NN	pace
history	NN	history
connection	NN	connection
like	JJ	like
x-files	NNS	<unknown>
path	NN	path
cruise	NN	cruise
godzilla	NN	<unknown>
images	NNS	image
segment	NN	segment
thriller	NN	thriller
hedwig	NN	<unknown>
element	NN	element
stereotypes	NNS	stereotype
lee	NN	lee
john	NN	john
focus	NN	focus
difficult	JJ	difficult
supposedly	RB	supposedly
experience	NN	experience
present	JJ	present
innocent	JJ	innocent
shaw	NN	shaw
why	WRB	why
equally	RB	equally
husband	NN	husband
effect	NN	effect
daniels	NNS	Daniel
whale	NN	whale
fourth	JJ	fourth
j	NN	j
charming	JJ	charming
truman	NP	Truman
'm	VBP	be
put	VBN	put
zardoz	NP	<unknown>
kills	VBZ	kill
apprentice	NN	apprentice
sets	VBZ	set
role	NN	role
constantly	RB	constantly
thought	VBD	think
population	NN	population
7	CD	7
jeff	NP	Jeff
due	JJ	due
catherine	NN	<unknown>
for	IN	for
totally	RB	totally
moral	JJ	moral
slapstick	NN	slapstick
students	NNS	student
glory	NN	glory
because	IN	because
means	NNS	mean
month	NN	month
possible	JJ	possible
image	NN	image
himself	PP	himself
york	VBP	york
whether	IN	whether
accent	NN	accent
expect	VB	expect
information	NN	information
spillane	NP	Spillane
long	JJ	long
asked	VBD	ask
appreciate	VB	appreciate
1999	CD	@card@
day	NN	day
think	VBP	think
derek	NP	Derek
desire	NN	desire
care	NN	care
oscar	NN	oscar
instance	NN	instance
taste	NN	taste
study	NN	study
ideas	NNS	idea
change	NN	change
dinner	NN	dinner
a	DT	a
's	POS	's
keeps	VBZ	keep
williamson	NP	Williamson
talent	NN	talent
parent	NN	parent
between	IN	between
visuals	NNS	visual
mars	NNS	mar
terms	NNS	term
unexpected	JJ	unexpected
work	VBP	work
toy	NN	toy
only	JJ	only
lawyer	NN	lawyer
create	VB	create
hell	NN	hell
these	DT	these
person	NN	person
telling	VBG	tell
receive	VB	receive
murphy	NN	murphy
went	VBD	go
worse	JJR	bad
hair	NN	hair
capture	VB	capture
blue	NN	blue
off	RP	off
video	JJ	video
player	NN	player
30	CD	@card@
absolute	JJ	absolute
ways	NNS	way
art	NN	art
scorsese	NN	<unknown>
chemistry	NN	chemistry
television	NN	television
jeopardy	NN	jeopardy
falling	VBG	fall
gere	NN	<unknown>
desperate	JJ	desperate
side	NN	side
're	VBP	be
syd	NP	Syd
name	NN	name
latest	JJS	late
care	VB	care
saving	VBG	save
proves	VBZ	prove
100	CD	@card@
store	NN	store
opens	VBZ	open
stunts	NNS	stunt
court	NN	court
figure	NN	figure
characters	NNS	character
painful	JJ	painful
fingernail	NN	fingernail
saturday	NN	Saturday
faith	NN	faith
past	JJ	past
trade	NN	trade
science	NN	science
smart	JJ	smart
the	NP	the
partner	NN	partner
theaters	NNS	theater
lover	NN	lover
toback	NP	Toback
traffic	NN	traffic
american	JJ	American
bond	NN	bond
david	NN	<unknown>
count	VB	count
william	NP	William
note	NN	note
comparison	NN	comparison
serious	JJ	serious
gun	NN	gun
come	VBP	come
plane	NN	plane
use	NN	use
slave	NN	slave
sonia	NN	<unknown>
friendship	NN	friendship
weird	JJ	weird
company	NN	company
voiced	VBN	voice
atmosphere	NN	atmosphere
learn	VB	learn
director	NN	director
appealing	VBG	appeal
&	CC	&
hearing	NN	hearing
named	VBN	name
sick	JJ	sick
doctor	NN	doctor
attorney	NN	attorney
pacing	VBG	pace
matter	NN	matter
working	VBG	work
dreams	VBZ	dream
press	NN	press
snakes	NNS	snake
studio	NN	studio
surprising	JJ	surprising
getting	VBG	get
engaging	JJ	engaging
wright	NN	wright
brought	VBN	bring
speech	NN	speech
recent	JJ	recent
happened	VBD	happen
claire	NP	Claire
happen	VB	happen
beyond	IN	beyond
up	RB	up
moments	NNS	moment
air	NN	air
being	VBG	be
villain	NN	villain
model	NN	model
new	JJ	new
realistic	JJ	realistic
yeoh	NN	<unknown>
problems	NNS	problem
somewhere	RB	somewhere
texas	NNS	<unknown>
regiment	NN	regiment
reeves	NNS	reeve
boss	NN	boss
yet	CC	yet
books	NNS	book
young	JJ	young
look	VB	look
fat	JJ	fat
deep	JJ	deep
robert	NP	Robert
follows	VBZ	follow
boys	NNS	boy
cookie	NN	cookie
keanu	NN	<unknown>
killing	VBG	kill
striking	JJ	striking
quirky	JJ	quirky
right	RB	right
charlotte	NN	charlotte
alicia	NN	<unknown>
martin	NN	martin
lama	NN	lama
right	NN	right
introduces	VBZ	introduce
suspects	NNS	suspect
tries	VBZ	try
wars	NNS	war
finally	RB	finally
scenes	NNS	scene
novel	NN	novel
13	CD	@card@
play	NN	play
wire	NN	wire
passion	NN	passion
ok	VB	ok
cat	NN	cat
[	SYM	[
steed	NN	steed
certain	JJ	certain
scheme	NN	scheme
explored	VBN	explore
big	JJ	big
take	VBP	take
really	RB	really
therefore	RB	therefore
suddenly	RB	suddenly
rival	JJ	rival
many	JJ	many
session	NN	session
early	JJ	early
hits	VBZ	hit
around	RP	around
mildly	RB	mildly
critique	NN	critique
sam	NN	<unknown>
mr	NN	Mr
imagination	NN	imagination
do	VBP	do
webb	NP	Webb
hard	JJ	hard
killed	VBN	kill
trap	NN	trap
typical	JJ	typical
chases	NNS	chase
_vampires_	NN	<unknown>
patrick	NN	<unknown>
pretty	RB	pretty
suicide	NN	suicide
death	NN	death
victim	NN	victim
way	NN	way
originally	RB	originally
stupid	JJ	stupid
through	RP	through
business	NN	business
both	CC	both
and	CC	and
down	RP	down
found	VBD	find
military	JJ	military
obligatory	JJ	obligatory
visually	RB	visually
know	VBP	know
van	NP	van
since	IN	since
spectacular	JJ	spectacular
boyfriend	NN	boyfriend
star	NN	star
truly	RB	truly
screen	NN	screen
lucy	NN	<unknown>
various	JJ	various
future	NN	future
loves	VBZ	love
cinematic	JJ	cinematic
case	NN	case
sorcerer	NN	sorcerer
against	IN	against
plan	NN	plan
segments	NNS	segment
immediately	RB	immediately
fights	NNS	fight
fun	NN	fun
important	JJ	important
include	VBP	include
you	PP	you
racism	NN	racism
car	NN	car
money	NN	money
jungle	NN	jungle
elevator	NN	elevator
dream	NN	dream
's	VBZ	have
alicia	NP	Alicia
lin	NN	<unknown>
such	JJ	such
given	VBN	give
jackson	NN	<unknown>
luck	NN	luck
bringing	VBG	bring
special	JJ	special
soldier	NN	soldier
off	RB	off
brooks	NNS	brook
plays	VBZ	play
sheer	JJ	sheer
worth	NN	worth
piece	NN	piece
sequels	NNS	sequel
chance	NN	chance
part	NN	part
always	RB	always
appearance	NN	appearance
manages	VBZ	manage
date	NN	date
gang	NN	gang
sit	VB	sit
put	VB	put
outstanding	JJ	outstanding
solid	JJ	solid
forget	VB	forget
dog	NN	dog
]	SYM	]
recommend	VB	recommend
been	VBN	be
on	RB	on
edge	NN	edge
any	RB	any
room	NN	room
allen	NP	Allen
musical	NN	musical
woman	NN	woman
shot	VBN	shoot
justice	NN	justice
pick	VBP	pick
=	SYM	=
lady	NN	lady
evil	JJ	evil
rise	NN	rise
his	PP$	his
two	CD	two
threat	NN	threat
pick	VB	pick
strength	NN	strength
jane	NN	jane
garrett	NP	Garrett
lacks	VBZ	lack
thing	NN	thing
question	NN	question
stir	VB	stir
moment	NN	moment
angel	NN	angel
michael	NP	Michael
se7en	NN	<unknown>
run	NN	run
nature	NN	nature
previous	JJ	previous
fantasia	NN	fantasia
sent	VBN	send
scott	NP	Scott
filled	VBN	fill
bring	VB	bring
torn	VBN	tear
english	JJ	English
came	VBD	come
feature	NN	feature
shot	NN	shot
inevitable	JJ	inevitable
sean	JJ	<unknown>
short	JJ	short
poorly	RB	poorly
fortune	NN	fortune
stigmata	NN	<unknown>
possibly	RB	possibly
buy	VB	buy
cash	NN	cash
turning	VBG	turn
famous	JJ	famous
written	VBN	write
nicely	RB	nicely
never	RB	never
southern	JJ	southern
nor	CC	nor
speaking	VBG	speak
consists	VBZ	consist
dying	VBG	die
veteran	NN	veteran
almost	RB	almost
guys	NNS	guy
rush	NN	rush
tony	JJ	tony
little	RB	little
mark	NN	mark
surprise	NN	surprise
he	PP	he
lead	VB	lead
highly	RB	highly
crap	NN	crap
les	FW	les
plot	NN	plot
hey	UH	hey
girl	NN	girl
training	NN	training
prinze	NN	<unknown>
birthday	NN	birthday
looking	VBG	look
few	JJ	few
have	VBP	have
main	JJ	main
naturally	RB	naturally
roxbury	NN	<unknown>
shoes	NNS	shoe
play	VB	play
gene	NN	gene
election	NN	election
casting	NN	casting
mainly	RB	mainly
give	VBP	give
on	RP	on
bit	NN	bit
toys	NNS	toy
extraordinary	JJ	extraordinary
ayla	NN	<unknown>
becoming	VBG	become
nothing	NN	nothing
wondering	VBG	wonder
in	RP	in
found	VBN	find
entertaining	JJ	entertaining
enough	RB	enough
dick	NN	dick
story	NN	story
dancer	NN	dancer
?	SENT	?
mind	NN	mind
features	NNS	feature
snake	NN	snake
screenwriters	NNS	screenwriter
bunch	NN	bunch
seemingly	RB	seemingly
worked	VBN	work
thrilling	JJ	thrilling
r	NN	r
mere	JJ	mere
exciting	JJ	exciting
robert	NN	<unknown>
relief	NN	relief
survive	VB	survive
learn	VBP	learn
come	VB	come
your	PP$	your
enjoyable	JJ	enjoyable
took	VBD	take
changed	VBN	change
someone	NN	someone
follow	VB	follow
contains	VBZ	contain
stands	VBZ	stand
about	RB	about
citizens	NNS	citizen
later	JJR	late
less	RBR	less
forward	RB	forward
leonard	NN	Leonard
done	VBN	do
anakin	NN	<unknown>
matthew	JJ	<unknown>
lam	NN	lam
leo	NN	<unknown>
subplots	NNS	subplot
preparing	VBG	prepare
best	RBS	well
dad	NN	dad
frankie	NN	<unknown>
away	RP	away
near	IN	near
caves	NNS	cave
campaign	NN	campaign
interest	NN	interest
premise	NN	premise
jay	NN	jay
its	PP$	its
easily	RB	easily
marvelous	JJ	marvelous
old	JJ	old
danny	NN	danny
rising	VBG	rise
space	NN	space
allen	NN	<unknown>
lake	NN	lake
greater	JJR	great
change	VB	change
today	NN	today
viewing	NN	viewing
down	RB	down
heard	VBN	hear
hopkins	NNS	<unknown>
as	IN	as
everyone	NN	everyone
fails	VBZ	fail
deliver	VB	deliver
blacks	NNS	black
life	NN	life
uninspired	JJ	uninspired
bill	NN	bill
eat	VB	eat
appear	VB	appear
favorite	JJ	favorite
tough	JJ	tough
older	JJR	old
absolutely	RB	absolutely
schumacher	NN	<unknown>
hilarious	JJ	hilarious
climactic	JJ	climactic
eventually	RB	eventually
yes	UH	yes
society	NN	society
originality	NN	originality
headed	VBN	head
needs	VBZ	need
fire	NN	fire
kevin	NN	<unknown>
easy	JJ	easy
college	NN	college
make	VBP	make
pet	JJ	pet
adds	VBZ	add
boone	NN	<unknown>
van	NN	van
trilogy	NN	trilogy
designer	NN	designer
china	NN	china
lisa	NP	Lisa
quite	RB	quite
strikes	VBZ	strike
tv	NN	tv
military	NN	military
hope	NN	hope
any	DT	any
move	VB	move
terribly	RB	terribly
happen	VBP	happen
pay	VB	pay
episode	NN	episode
apostle	NN	apostle
ford	NN	ford
late	JJ	late
phone	NN	phone
slick	JJ	slick
spot	NN	spot
concept	NN	concept
wrote	VBD	write
heroes	NNS	hero
live	VBP	live
event	NN	event
owens	NNS	<unknown>
often	RB	often
rick	NN	rick
offensive	JJ	offensive
played	VBD	play
eating	VBG	eat
erotic	JJ	erotic
warren	NN	warren
scientist	NN	scientist
system	NN	system
find	VBP	find
maximum	JJ	maximum
government	NN	government
attitude	NN	attitude
feeling	VBG	feel
kill	VB	kill
angels	NNS	angel
all	DT	all
accused	VBN	accuse
opportunity	NN	opportunity
forced	VBN	force
herself	PP	herself
clear	JJ	clear
social	JJ	social
stigmata	NNS	<unknown>
heart	NN	heart
rock	NN	rock
failure	NN	failure
disappointed	VBN	disappoint
michele	NN	<unknown>
gives	VBZ	give
love	VBP	love
state	NN	state
rescue	VB	rescue
pride	NN	pride
there	EX	there
angry	JJ	angry
stephen	NN	<unknown>
qui-gon	NN	<unknown>
no	DT	no
disaster	NN	disaster
high	JJ	high
sidney	NP	Sidney
sure	JJ	sure
pointless	JJ	pointless
bernstein	NN	<unknown>
means	VBZ	mean
light	NN	light
edition	NN	edition
remarkable	JJ	remarkable
twice	RB	twice
language	NN	language
book	NN	book
common	JJ	common
sci-fi	NN	sci-fi
galactic	JJ	galactic
sitting	VBG	sit
kevin	NP	Kevin
our	PP$	our
costumes	NNS	costume
quickly	RB	quickly
wealthy	JJ	wealthy
calls	VBZ	call
way	RB	way
clue	NN	clue
memphis	NNS	<unknown>
leaves	VBZ	leave
opinion	NN	opinion
stars	NNS	star
saying	VBG	say
hong	NN	hong
holes	NNS	hole
bowling	NN	bowling
left	VBN	leave
small	JJ	small
full	JJ	full
luc	NN	<unknown>
enough	JJ	enough
apart	RB	apart
i	FW	i
harding	NN	<unknown>
sidekick	NN	sidekick
during	IN	during
ii	NN	<unknown>
brings	VBZ	bring
friend	NN	friend
shannon	NN	<unknown>
damme	NP	<unknown>
also	RB	also
filmmakers	NNS	filmmaker
self	NN	self
ensemble	NN	ensemble
variety	NN	variety
fifth	JJ	fifth
begin	VBP	begin
top-notch	JJ	top-notch
program	NN	program
brilliant	JJ	brilliant
,	,	,
popular	JJ	popular
towards	IN	towards
escape	NN	escape
los	NP	los
becomes	VBZ	become
legendary	JJ	legendary
mysterious	JJ	mysterious
god	NN	god
other	JJ	other
attack	NN	attack
expectations	NNS	expectation
bloody	JJ	bloody
jackal	NN	jackal
town	NN	town
already	RB	already
loser	NN	loser
save	VB	save
thrillers	NNS	thriller
member	NN	member
s	NN	S
perfectly	RB	perfectly
might	MD	might
throwing	VBG	throw
though	IN	though
open	JJ	open
back	NN	back
tone	NN	tone
officer	NN	officer
amusing	JJ	amusing
turn	VB	turn
released	VBN	release
playing	VBG	play
connery	NN	<unknown>
view	NN	view
takes	VBZ	take
conclusion	NN	conclusion
visions	NNS	vision
keep	VB	keep
says	VBZ	say
heavy	JJ	heavy
film	NN	film
continues	VBZ	continue
trite	JJ	trite
williams	NP	Williams
fear	VBP	fear
parents	NNS	parent
kids	NNS	kid
earlier	JJR	early
machine	NN	machine
human	JJ	human
ben	NN	ben
had	VBD	have
one-dimensional	JJ	one-dimensional
say	VB	say
loud	JJ	loud
water	NN	water
soldiers	NNS	soldier
minutes	NNS	minute
parker	NN	<unknown>
army	NN	army
brain	NN	brain
drug	NN	drug
norton	NP	Norton
take	VB	take
try	VBP	try
ed	NN	editor
cheap	JJ	cheap
romance	NN	romance
intelligent	JJ	intelligent
want	VB	want
appears	VBZ	appear
most	JJS	most
comedic	JJ	comedic
toward	IN	toward
boat	NN	boat
student	NN	student
80	CD	@card@
break	VB	break
their	PP$	their
cox	NN	cox
clan	NN	clan
coming	VBG	come
butt	NN	butt
attempt	NN	attempt
anyway	RB	anyway
effective	JJ	effective
form	NN	form
shining	VBG	shine
clearly	RB	clearly
jackie	NN	<unknown>
one	PP	one
known	VBN	know
longer	RBR	longer
sense	NN	sense
tibet	NN	<unknown>
cinema	NN	cinema
whales	NNS	whale
amidala	NN	<unknown>
along	RB	along
copy	NN	copy
neeson	NP	Neeson
highlander	NN	Highlander
bacon	NN	bacon
pieces	NNS	piece
comet	NN	comet
german	JJ	german
hannah	NN	<unknown>
g	NN	g
sun	NN	sun
turned	VBD	turn
collection	NN	collection
palma	NP	Palma
quick	JJ	quick
that	WDT	that
memorable	JJ	memorable
scream	NN	scream
off	IN	off
no	UH	no
fine	JJ	fine
brothers	NNS	brother
music	NN	music
half	PDT	half
drama	NN	drama
snipes	NNS	snipe
woods	NNS	wood
wonder	NN	wonder
n't	RB	n't
jennifer	NN	<unknown>
beginning	NN	beginning
lifeless	JJ	lifeless
points	NNS	point
andy	NN	<unknown>
house	NN	house
denise	NP	Denise
asks	VBZ	ask
floor	NN	floor
successfully	RB	successfully
broken	VBN	break
days	NNS	day
seriously	RB	seriously
neither	CC	neither
guilty	JJ	guilty
levels	NNS	level
learning	VBG	learn
works	VBZ	work
laugh	NN	laugh
obviously	RB	obviously
yet	RB	yet
knowing	VBG	know
us	PP	us
say	VBP	say
sweet	JJ	sweet
either	RB	either
believe	VB	believe
frank	JJ	frank
cannot	MD	can
head	NN	head
overall	JJ	overall
intensity	NN	intensity
use	VBP	use
--	:	--
trademark	NN	trademark
shocking	JJ	shocking
magical	JJ	magical
gets	VBZ	get
ridiculous	JJ	ridiculous
as	RB	as
team	NN	team
hammer	NN	hammer
_shaft_	NN	<unknown>
adults	NNS	adult
darth	NN	<unknown>
act	NN	act
fly	VB	fly
track	NN	track
tibetan	JJ	Tibetan
pure	JJ	pure
strong	JJ	strong
people	NNS	people
speaks	VBZ	speak
tells	VBZ	tell
honest	JJ	honest
made	VBN	make
nazi	NN	Nazi
decides	VBZ	decide
normal	JJ	normal
however	RB	however
1	CD	1
train	NN	train
thankfully	RB	thankfully
great	JJ	great
moving	VBG	move
truth	NN	truth
bigger	JJR	big
artist	NN	artist
apparently	RB	apparently
virus	NN	virus
trash	NN	trash
knew	VBD	know
'd	MD	will
born	VBN	bear
deserves	VBZ	deserve
acting	JJ	acting
family	NN	family
mission	NN	mission
catchy	JJ	catchy
closer	JJR	close
slow	JJ	slow
months	NNS	month
genre	NN	genre
decision	NN	decision
feet	NNS	foot
alone	RB	alone
ends	VBZ	end
work	VB	work
syd	NN	<unknown>
alien	JJ	alien
certainly	RB	certainly
completely	RB	completely
e	LS	e
dark	JJ	dark
french	NN	French
bowden	NP	Bowden
seems	VBZ	seem
ocean	NN	ocean
writing	NN	writing
place	NN	place
each	DT	each
academy	NN	academy
matters	NNS	matter
wasted	VBN	waste
schwimmer	NN	<unknown>
twins	NNS	twin
reasons	NNS	reason
worst	JJS	bad
school	NN	school
bresson	NP	<unknown>
taylor	NP	Taylor
theory	NN	theory
what	WP	what
nudity	NN	nudity
complicated	JJ	complicated
rising	NN	rising
brown	JJ	brown
laugh	VB	laugh
spent	VBN	spend
*	SYM	*
significant	JJ	significant
flight	NN	flight
reason	NN	reason
making	VBG	make
away	RB	away
o'donnell	NP	O'donnell
sherry	NN	sherry
four	CD	four
half	NN	half
gay	JJ	gay
well	RB	well
mrs	NNS	<unknown>
washington	NP	Washington
hold	VB	hold
fall	NN	fall
runs	VBZ	run
mel	NN	mel
lives	NNS	life
arts	NNS	art
search	NN	search
growing	VBG	grow
brilliantly	RB	brilliantly
dalai	NN	<unknown>
respect	NN	respect
think	VB	think
enjoy	VB	enjoy
batman	NN	batman
thrown	VBN	throw
movies	NNS	movie
club	NN	club
men	NNS	man
fugitive	NN	fugitive
clich	NN	<unknown>
confusing	JJ	confusing
technical	JJ	technical
particular	JJ	particular
hands	NNS	hand
lack	NN	lack
father	NN	father
together	RB	together
feel	VBP	feel
slightly	RB	slightly
throw	VB	throw
baseball	NN	baseball
makes	VBZ	make
will	MD	will
nonetheless	RB	nonetheless
such	PDT	such
performance	NN	performance
including	VBG	include
baby	NN	baby
blockbuster	NN	blockbuster
clint	NN	<unknown>
sphere	NN	sphere
hoffman	NN	<unknown>
despite	IN	despite
horrible	JJ	horrible
further	RBR	further
score	NN	score
murray	NN	<unknown>
offers	VBZ	offer
christopher	NN	<unknown>
up	IN	up
kind	NN	kind
me	PP	me
built	VBN	build
slight	JJ	slight
thoughts	NNS	thought
jury	NN	jury
andrew	NN	<unknown>
handle	VB	handle
directed	VBN	direct
modern	JJ	modern
xusia	NN	<unknown>
things	NNS	thing
don	NN	don
seagal	JJ	<unknown>
run	VB	run
astonishing	JJ	astonishing
impossible	JJ	impossible
woo	VB	woo
feel	VB	feel
couple	NN	couple
impression	NN	impression
-	:	-
younger	JJR	young
jr	NN	<unknown>
poor	JJ	poor
ryan	NN	<unknown>
before	IN	before
third	JJ	third
brought	VBD	bring
eastwood	NN	<unknown>
usual	JJ	usual
cameras	NNS	camera
ray	NN	ray
robin	NN	robin
job	NN	job
drawn	VBN	draw
make-up	NN	make-up
audiences	NNS	audience
ramsey	NP	Ramsey
duvall	NN	<unknown>
albeit	IN	albeit
mike	NN	mike
conversation	NN	conversation
bear	NN	bear
large	JJ	large
keaton	NP	Keaton
asking	VBG	ask
subject	JJ	subject
public	JJ	public
girls	NNS	girl
looks	NNS	look
'	''	'
david	JJ	<unknown>
songs	NNS	song
south	JJ	south
own	JJ	own
sounds	NNS	sound
service	NN	service
but	CC	but
interesting	JJ	interesting
should	MD	should
build	VB	build
harrison	NN	<unknown>
ambitious	JJ	ambitious
imax	NN	<unknown>
star	JJ	star
religious	JJ	religious
mentioned	VBN	mention
commentary	NN	commentary
animals	NNS	animal
beatrice	NN	Beatrice
race	NN	race
logic	NN	logic
anna	NN	anna
are	VBP	be
force	NN	force
goofy	JJ	goofy
exotica	NN	exotica
meets	VBZ	meet
cinematography	NN	cinematography
carry	VB	carry
win	VB	win
tension	NN	tension
1997	CD	@card@
may	MD	may
returns	NNS	return
greg	NN	<unknown>
hunt	NN	hunt
every	DT	every
more	JJR	more
brenner	NP	Brenner
here	RB	here
male	JJ	male
richard	NN	<unknown>
twists	NNS	twist
minute	NN	minute
step	NN	step
wonderfully	RB	wonderfully
sexual	JJ	sexual
above	IN	above
sound	NN	sound
momma	NN	momma
prince	NN	prince
aforementioned	JJ	aforementioned
humans	NNS	human
thinks	VBZ	think
provide	VB	provide
nowhere	RB	nowhere
unfunny	JJ	unfunny
emotional	JJ	emotional
right	JJ	right
angeles	NNS	<unknown>
ca	MD	ca
based	VBN	base
incredibly	RB	incredibly
theatre	NN	theatre
waste	VB	waste
jawbreaker	NN	jawbreaker
usually	RB	usually
front	NN	front
nobody	NN	nobody
laughable	JJ	laughable
fresh	JJ	fresh
james	NNS	<unknown>
over	RP	over
beginning	VBG	begin
wo	MD	wo
now	RB	now
both	DT	both
crew	NN	crew
hoping	VBG	hope
process	NN	process
writer	NN	writer
compelling	JJ	compelling
perfect	JJ	perfect
george	NP	George
cliches	NNS	clich
the	DT	the
game	NN	game
eye	NN	eye
purpose	NN	purpose
seeing	VBG	see
julia	NN	<unknown>
babe	NN	babe
field	NN	field
moved	VBN	move
office	NN	office
sometimes	RB	sometimes
starts	VBZ	start
scientists	NNS	scientist
show	VBP	show
blake	NN	<unknown>
9	CD	9
glass	NN	glass
feelings	NNS	feeling
chosen	VBN	choose
amazing	JJ	amazing
aside	RB	aside
touch	NN	touch
substance	NN	substance
woody	JJ	woody
inspector	NN	inspector
gone	VBN	go
superior	JJ	superior
1998	CD	@card@
world	NN	world
watching	VBG	watch
dialogue	NN	dialogue
numbers	NNS	number
become	VB	become
pacino	NP	Pacino
helps	VBZ	help
camera	NN	camera
using	VBG	use
allowed	VBN	allow
angela	NN	<unknown>
involved	VBN	involve
believe	VBP	believe
convincing	JJ	convincing
jean	NN	jean
actually	RB	actually
dude	NN	dude
doing	VBG	do
shows	VBZ	show
added	VBN	add
dr	NN	Dr
obvious	JJ	obvious
turns	NNS	turn
looks	VBZ	look
apes	NNS	ape
script	NN	script
lovers	NNS	lover
echoes	NNS	echo
notable	JJ	notable
toy	JJ	toy
while	NN	while
literally	RB	literally
pursuit	NN	pursuit
though	RB	though
writers	NNS	writer
causes	VBZ	cause
fashion	NN	fashion
walking	VBG	walk
season	NN	season
puts	VBZ	put
monsters	NNS	monster
chris	NP	Chris
worthy	JJ	worthy
giant	JJ	giant
surprised	VBN	surprise
intelligence	NN	intelligence
home	NN	home
onto	IN	onto
giving	VBG	give
boy	NN	boy
battle	NN	battle
sequence	NN	sequence
talking	VBG	talk
am	VBP	be
crawford	NP	Crawford
message	NN	message
mercury	NN	mercury
stone	NN	stone
work	NN	work
control	NN	control
paper	NN	paper
baldwin	NP	Baldwin
birds	NNS	bird
up	RP	up
explain	VB	explain
probably	RB	probably
fast	RB	fast
al	NP	al
cheesy	JJ	cheesy
tracy	NN	<unknown>
trouble	NN	trouble
affair	NN	affair
downfall	NN	downfall
tatooine	NN	<unknown>
lancelot	NN	<unknown>
bob	NN	bob
familiar	JJ	familiar
tragic	JJ	tragic
sad	JJ	sad
valek	NP	Valek
fast	JJ	fast
manage	VBP	manage
rule	NN	rule
everything	NN	everything
jedi	NN	<unknown>
result	NN	result
not	RB	not
archer	NN	archer
range	NN	range
3	CD	3
celebrity	NN	celebrity
lots	NNS	lot
leads	VBZ	lead
definitely	RB	definitely
shoot	VB	shoot
wife	NN	wife
considering	VBG	consider
merely	RB	merely
reviews	NNS	review
man	NN	man
seth	NP	Seth
miserables	NNS	<unknown>
lacking	VBG	lack
wai	NN	<unknown>
dramatic	JJ	dramatic
cameo	NN	cameo
scary	JJ	scary
rating	NN	rating
maggie	NN	maggie
like	VB	like
features	VBZ	feature
nothing	RB	nothing
ten	CD	ten
ice	NN	ice
look	VBP	look
video	NN	video
enjoyment	NN	enjoyment
three	CD	three
nick	NN	nick
joke	NN	joke
blucas	NNS	<unknown>
humor	NN	humor
contact	NN	contact
prove	VB	prove
end	NN	end
spends	VBZ	spend
wooden	JJ	wooden
bad	JJ	bad
predictable	JJ	predictable
unbelievable	JJ	unbelievable
said	VBD	say
but	RB	but
ride	NN	ride
women	NNS	woman
daughter	NN	daughter
terrific	JJ	terrific
wyatt	NN	<unknown>
sprite	NN	sprite
none	NN	none
different	JJ	different
picture	NN	picture
guns	NNS	gun
critics	NNS	critic
across	IN	across
wanted	VBD	want
steps	NNS	step
her	PP	her
harry	VB	harry
sight	NN	sight
destroy	VB	destroy
sister	NN	sister
turn	NN	turn
paul	NN	<unknown>
ending	VBG	end
wrongfully	RB	wrongfully
christmas	NNS	<unknown>
rich	JJ	rich
ask	VB	ask
screenplay	NN	screenplay
tend	VBP	tend
filmmaking	VBG	filmmak
quite	PDT	quite
trying	VBG	try
either	DT	either
started	VBD	start
pathetic	JJ	pathetic
australian	JJ	Australian
described	VBN	describe
russian	JJ	Russian
tale	NN	tale
warner	NN	warner
crow	NN	crow
deniro	NN	<unknown>
blair	NP	Blair
simon	NN	<unknown>
positive	JJ	positive
yourself	PP	yourself
sins	NNS	sin
appealing	JJ	appealing
involves	VBZ	involve
sentimental	JJ	sentimental
films	NNS	film
learns	VBZ	learn
teacher	NN	teacher
prank	NN	prank
wrong	JJ	wrong
community	NN	community
capable	JJ	capable
exception	NN	exception
queens	NNS	queen
feels	VBZ	feel
imagine	VB	imagine
cute	JJ	cute
impact	NN	impact
witch	NN	witch
notion	NN	notion
lame	JJ	lame
fifteen	CD	fifteen
end	VB	end
pull	VB	pull
questions	NNS	question
apartment	NN	apartment
want	VBP	want
party	NN	party
wait	VB	wait
cameron	NN	<unknown>
ranks	VBZ	rank
fair	JJ	fair
test	NN	test
awful	JJ	awful
oh	UH	oh
hero	NN	hero
once	RB	once
epic	NN	epic
handful	NN	handful
subtle	JJ	subtle
else	RB	else
jenny	NN	jenny
filmed	VBN	film
carpenter	NN	carpenter
peel	NN	peel
roles	NNS	role
see	VBP	see
week	NN	week
alcohol	NN	alcohol
living	NN	living
anne	NN	<unknown>
jack	NN	jack
entirely	RB	entirely
lesson	NN	lesson
still	RB	still
others	NNS	other
start	NN	start
version	NN	version
over	RB	over
teenagers	NNS	teenager
stuff	NN	stuff
gorgeous	JJ	gorgeous
titanic	JJ	titanic
terrorists	NNS	terrorist
formula	NN	formula
talented	JJ	talented
church	NN	church
miss	VB	miss
thinking	VBG	think
visual	JJ	visual
become	VBN	become
cave	NN	cave
rest	NN	rest
final	JJ	final
exactly	RB	exactly
task	NN	task
relationships	NNS	relationship
fascinating	JJ	fascinating
heche	NN	<unknown>
exotic	JJ	exotic
families	NNS	family
earth	NN	earth
past	NN	past
flick	NN	flick
read	VBN	read
attention	NN	attention
pair	NN	pair
tiresome	JJ	tiresome
disney	NP	Disney
eight	CD	eight
agent	NN	agent
free	JJ	free
sex	NN	sex
park	NN	park
lebowski	NP	<unknown>
come	VBN	come
approach	NN	approach
unlike	IN	unlike
remembered	VBN	remember
flat	JJ	flat
following	VBG	follow
used	VBD	use
lou	NN	<unknown>
fantine	NN	<unknown>
did	VBD	do
child	NN	child
streets	NNS	street
humanity	NN	humanity
brief	JJ	brief
anything	NN	anything
de	NP	de
frame	NN	frame
unusual	JJ	unusual
law	NN	law
nixon	NN	<unknown>
release	NN	release
local	JJ	local
watch	VBP	watch
theme	NN	theme
uses	VBZ	use
fox	NN	fox
laughs	NNS	laugh
classic	JJ	classic
eyes	NNS	eye
radio	NN	radio
inspiration	NN	inspiration
motion	NN	motion
fan	NN	fan
one-liners	NNS	one-liner
five	CD	five
worked	VBD	work
generation	NN	generation
children	NNS	child
confident	JJ	confident
mind	VB	mind
taking	VBG	take
warm	JJ	warm
violent	JJ	violent
from	IN	from
rolling	VBG	roll
show	NN	show
teenage	JJ	teenage
upon	IN	upon
ground	NN	ground
stop	VB	stop
ahead	RB	ahead
beautiful	JJ	beautiful
'll	MD	will
record	NN	record
even	RB	even
arquette	NN	<unknown>
devil	NN	devil
bottom	JJ	bottom
some	DT	some
course	NN	course
unique	JJ	unique
themselves	PP	themselves
parts	NNS	part
follow	VBP	follow
menace	NN	menace
anyone	NN	anyone
choices	NNS	choice
works	NNS	work
`	``	`
stiller	JJR	still
birth	NN	birth
hit	NN	hit
finding	VBG	find
disco	NN	disco
lost	VBD	lose
cult	NN	cult
see	VB	see
until	IN	until
alvarado	NN	<unknown>
crazy	JJ	crazy
body	NN	body
before	RB	before
dollars	NNS	dollar
seemed	VBD	seem
enjoyed	VBD	enjoy
going	VBG	go
victims	NNS	victim
promise	NN	promise
meet	VBP	meet
try	VB	try
problem	NN	problem
named	VBD	name
far	RB	far
arthur	NN	<unknown>
details	NNS	detail
mystery	NN	mystery
hard	RB	hard
kundun	NN	<unknown>
romantic	JJ	romantic
trail	NN	trail
ending	NN	ending
pupil	NN	pupil
over	IN	over
ethan	NN	<unknown>
disappointment	NN	disappointment
amount	NN	amount
enjoying	VBG	enjoy
surprises	NNS	surprise
jones	NNS	<unknown>
second	JJ	second
aaron	NN	<unknown>
fully	RB	fully
witherspoon	NN	<unknown>
top	JJ	top
rare	JJ	rare
leaving	VBG	leave
truman	NN	<unknown>
than	IN	than
sole	JJ	sole
inch	NN	inch
barb	NN	barb
adventure	NN	adventure
voice	NN	voice
disney	NN	<unknown>
happy	JJ	happy
taken	VBN	take
cartoon	NN	cartoon
run	VBN	run
mother	NN	mother
mess	NN	mess
coen	NN	<unknown>
friends	NNS	friend
seven	CD	seven
likely	JJ	likely
facts	NNS	fact
singer	NN	singer
accident	NN	accident
kid	NN	kid
while	IN	while
illegal	JJ	illegal
previews	NNS	preview
talk	NN	talk
delivery	NN	delivery
mozart	NN	<unknown>
dussander	NN	<unknown>
rarely	RB	rarely
vampires	NNS	vampire
lee	JJ	lee
stand	VB	stand
leading	VBG	lead
nelson	NN	nelson
initially	RB	initially
invasion	NN	invasion
whose	WP$	whose
historical	JJ	historical
major	JJ	major
strongly	RB	strongly
fact	NN	fact
clever	JJ	clever
anaconda	NN	anaconda
ruin	VB	ruin
unfortunately	RB	unfortunately
feeling	NN	feeling
smith	NN	smith
romy	NN	<unknown>
terrible	JJ	terrible
producers	NNS	producer
style	NN	style
armageddon	NP	Armageddon
female	JJ	female
wit	NN	wit
fellow	JJ	fellow
news	NN	news
assignment	NN	assignment
largely	RB	largely
shooting	VBG	shoot
chick	NN	chick
buddies	NNS	buddy
throughout	IN	throughout
likable	JJ	likable
success	NN	success
pulls	VBZ	pull
decade	NN	decade
moves	VBZ	move
cast	NN	cast
cut	NN	cut
complete	JJ	complete
felt	VBD	feel
directing	VBG	direct
teen	JJ	teen
tom	NN	tom
portrayal	NN	portrayal
ass	NN	ass
sequences	NNS	sequence
top	NN	top
target	NN	target
personal	JJ	personal
of	IN	of
acting	NN	acting
l	NN	l
project	NN	project
similar	JJ	similar
original	JJ	original
overwhelming	JJ	overwhelming
dirty	JJ	dirty
lucas	NNS	<unknown>
flaws	NNS	flaw
filming	VBG	film
davis	NN	<unknown>
detective	NN	detective
called	VBN	call
odd	JJ	odd
expects	VBZ	expect
it	PP	it
movement	NN	movement
owner	NN	owner
wonderful	JJ	wonderful
natasha	NN	<unknown>
crime	NN	crime
overall	RB	overall
natural	JJ	natural
america	NN	<unknown>
numerous	JJ	numerous
painfully	RB	painfully
tried	VBD	try
got	VBN	get
elements	NNS	element
live	VB	live
alice	NN	<unknown>
ann	NP	Ann
opening	NN	opening
set	NN	set
stage	NN	stage
presented	VBN	present
grows	VBZ	grow
lies	VBZ	lie
notice	VB	notice
viewed	VBN	view
joins	VBZ	join
shown	VBN	show
steven	JJ	<unknown>
charles	NNS	<unknown>
skinhead	NN	skinhead
speechless	JJ	speechless
disturbing	JJ	disturbing
dull	JJ	dull
hardly	RB	hardly
sword	NN	sword
risk	NN	risk
country	NN	country
former	JJ	former
back	RB	back
phantom	JJ	phantom
sixth	JJ	sixth
cook	NN	cook
aliens	NNS	alien
that	DT	that
dress	NN	dress
return	NN	return
gore	NN	gore
wants	VBZ	want
fbi	NP	<unknown>
let	VB	let
knowledge	NN	knowledge
accept	VB	accept
watch	VB	watch
(	(	(
george	NN	<unknown>
etc	FW	etc
love	VB	love
includes	VBZ	include
leave	VB	leave
without	IN	without
class	NN	class
position	NN	position
able	JJ	able
utterly	RB	utterly
series	NN	series
bruce	NN	<unknown>
movie	NN	movie
period	NN	period
freedom	NN	freedom
ultimately	RB	ultimately
mostly	RB	mostly
killer	NN	killer
interested	JJ	interested
hanks	NNS	hank
meanwhile	RB	meanwhile
fans	NNS	fan
feel	NN	feel
lambert	NN	lambert
him	PP	him
shop	NN	shop
out	IN	out
attempts	NNS	attempt
placed	VBN	place
talon	NN	talon
caught	VBN	catch
defense	NN	defense
political	JJ	political
example	NN	example
prison	NN	prison
rachel	NN	<unknown>
write	VB	write
kiki	NP	Kiki
leads	NNS	lead
aspect	NN	aspect
distracting	JJ	distracting
decided	VBD	decide
charm	NN	charm
fighting	VBG	fight
beauty	NN	beauty
'28	JJ	<unknown>
avengers	NNS	avenger
strange	JJ	strange
development	NN	development
mulder	NN	<unknown>
powerful	JJ	powerful
steals	VBZ	steal
wisely	RB	wisely
level	NN	level
touching	JJ	touching
have	VB	have
hank	NN	hank
get	VBP	get
single	JJ	single
anthony	NN	<unknown>
mills	NNS	mill
gadget	NN	gadget
asked	VBN	ask
physical	JJ	physical
paul	NP	Paul
reporter	NN	reporter
remotely	RB	remotely
dies	VBZ	die
everybody	NN	everybody
performances	NNS	performance
actresses	NNS	actress
million	CD	million
perhaps	RB	perhaps
indeed	RB	indeed
extreme	JJ	extreme
deal	NN	deal
cool	JJ	cool
then	RB	then
brother	NN	brother
showing	VBG	show
5/	CD	@card@
although	IN	although
bats	NNS	bat
michelle	NN	Michelle
dealing	VBG	deal
troma	NN	<unknown>
intriguing	JJ	intriguing
straight	JJ	straight
group	NN	group
u	NN	u
lawrence	NN	<unknown>
sky	NN	sky
conflict	NN	conflict
putting	VBG	put
editing	VBG	edit
rooms	NNS	room
discovers	VBZ	discover
heather	JJ	heather
screenwriter	NN	screenwriter
events	NNS	event
watched	VBD	watch
members	NNS	member
waste	NN	waste
background	NN	background
camp	NN	camp
sir	NN	sir
superficial	JJ	superficial
jake	NN	Jake
dutch	NN	dutch
vampire	NN	vampire
subject	NN	subject
ross	NN	<unknown>
later	RBR	later
credits	NNS	credit
trapped	VBN	trap
wainwright	NN	wainwright
masterpiece	NN	masterpiece
generally	RB	generally
show	VB	show
liam	NP	Liam
status	NN	status
fantastic	JJ	fantastic
groundhog	NN	<unknown>
accomplished	VBN	accomplish
in	RB	in
displays	VBZ	display
outrageous	JJ	outrageous
freeze	NN	freeze
knights	NNS	knight
acting	VBG	act
martial	JJ	martial
budget	NN	budget
footage	NN	footage
proverbial	JJ	proverbial
nights	NNS	night
remains	VBZ	remain
disappointing	JJ	disappointing
presidential	JJ	presidential
